WLLWLLLLLW
LSLLLWWLWL
LWLLLLWLLL
LLLWWWLWLL
LLLWWWLLLL
WLLWWLLLLW
LLLLLWLLWL
LWWLLLLLWW
LLLLLLLLLW
LLLLLWLELL