LWLLLLLWLW
LSWLLLWWWL
WLLLWLWLLW
LLLLLLLLLL
LLLLLLWLWW
LWLLLWWLLW
WWWWWLLWLW
LLLLLWWELW
LLLWLLLLWW
LLWLWWWLLL