LWWLLWWLWL
LLLWLWLLLL
LLLWLLLLLL
LWLLWLLLLL
WLLLWWWWLL
WLLWLLLLLL
LLLLLLWLLL
LWLLLWLWLL
LLLLLLWLLW
LLLWLWLLWW