LWLSWLWLLWLLWLLLWLLLLLLLLLLWLLWLLLLWLLWWLLLLLWLWWW
LWLLLLLLWLLWLWLLWWLWLLLLWLWLLLWLLLLLLLLLLWLLLLLLLW
LLLLLLLLLLLWLLLLLLLLLLLLWLLWWWLLLLLLWWLLLLLWWLWLLW
WWLLWLWLWLWLLLLLWLLWLLWLLLLLLLLLLWLLLLLLLWLLLLLLLL
LLLLLLWWWLWLWLLWLWLWLLLLWLLLWLLLWWLWLLWWLLLWWWLWLL
LLWWWLWLLLLLLLLLLWLLLLLLLWLWLLWLWLLWLLLLWWLLLWLLLL
LLLLWWWWLLLWWLLWLLLLLLLLLLLLWLLLLWWLLLLLLLLLWLLWLL
LWLLLWLWLWWLWLWLLLLLWWLLLLLWLLWLLLLLWLLLLLWLLLLLLL
LLLWLWLLLLLLLLLLLWLLLWWLLLLLWWWLWWWLLLLWWLLLLLLLLW
LLWLLWLLLWLLLLLLLWWLWLWWLLLLWLWLLWLLLLWLWLWWWLLWWL
LLWWWWWLWLLLLWLWLWLLLLWLLLLLWWLLWWLLLLLLWLLLLLWLLW
WLLLLWLLLWWLLLLLWLLLWWWWLLLLLWLWLLLLWLLLLLLWLLLLWL
WLWLLLLLLLLWLLLWWLWLLWWLLLLLLWLLLLLLWWLWLWLLLWLWWW
LLLWLLLLWLLLLWLLLWLLLWLLLWWWLLLLLWWLLWWWWLWWWLWLLL
LLWLLLWLLLLLLLWLLLLLLLLLWLLWLLLLLLLLLLLLLLLLLLLLWW
LLLWWLLLWLLWLLLLWWLLLLWLLWLWWWWLWLLLWLLLLWWLLWWLLW
LLLLLWLLLWLLLWLLWLLWWLWLWLLWLLLLLWLLLLLWLWLLLLLLLW
LLLLLLWLLWLWLLLLLWWLWLWLWLWWWLLLLLLWLLLWWWWLLWWLLW
WLLLLLWLWLWLLLLWLLWWWLLLWLLWWLLLLLLLLLLLLLWLLLLLLL
LLLLWWLLLWWLWLLLLWLLLWLWLLLLLWLWLLLLLLLLLLLLLLLLWL
LWWWLWWWLLLWLLWLWLLLWWWLLLLWLLWLWLWLLWLLLLLLLLLWLL
LLLWWLLWLWLLLWLLLLELLLLWLWLLLLLWLLLLWLWWWWWLLLLLLW
LLLLLWLWLWWLWWWLLWLLWLLWWLWWLLLLLLWLLLWLWLWLLWLWLL
LLLLLLWLLLLLWLLLWLLLLLLWLLWLLWLLWLWLLWLLWLWWLLLLWL
WLLLWWWLLLLLWWLWWLLWLLLWLWWLWLLWLLLWLLLLLLWLWLLLLL
WLWLLLWWLLLLWLLLWWLLLLWLWLLLLLLWLLWLLLLLLLLLWLLLWL
WLLWLWLLLLWWWLLWLLLLWLWWWLLLLLLLLLLLLLLLLWLLLWLLLW
LLWWLWWLWWLLLLLLLLLLLLLLLWLLLLLLWLLWLLLLLLLWWLLLLW
LWLLLLLLLLLWLLWLLLWWLWLLLLWLLLLWLWLLLLLLWLLLLWLLWL
LLLWLLLLLWLWLWLLLLLLWWLLLLLLLLLLLLLWLLLWLLWWLLWLWL
LLLWLLLLLWLWLLWWLWLLWWLLWLLLLLWLLLLLLLWWLWLWWLLLLL
LLLWLLLWWLWLLLLLLWWWLLWLLLLWWWLLLLLLLLWLLWWLLWLWLW
LWWLWLLLLLLLLLWLWLWLWLLLWLWLLWLLLLLLLLLLLLLWLLLWWW
LLLLLLLLWWLLLLWWLWLLLLWLLWLLWWLWLWLLWLLLLLLLLWWLLL
LLLLLLWWWLWLLWWLLWLLLWWLWLLLLWWLLWWLLWLLLLWLWWLLLW
LWLLLLLWLLLLLLLWLLWLLLWLLLLLLLLLLLLWLLLLLLLLWWLWLL
LWLLWLWLWLLLWWLLLWWLLLLLLLLLLLLLLWWLWLLWLLWWLLWLLL
LLWWLLWLLWLLLWLLLLLWLLLWWWWLLWLLLWWWLLLWWLLLLWWLWL
LLLLLLWLLWWLLLLLLLLLLLWLLLLLLLLWWWWLLLLWLLLLWLLWWL
WWLLLLWLLLLWLLLLLLLLWLLWLLLWLLLLLWWLWLLLLLLLLLLLLL
LLWWLLWLLWWLLWWLWLWWLLLLLLLWLWWLWLLLLLWLLLLLWLLLLL
LLLWWWWLWLLWWLLLLWLLLLLLLLLWLWLWLLLLLWWWLLLWLLWWLL
LLWLWLLLLWLLWLWLLLLLLLLLLLLLLLLLLLWWLLLWLLLLLWWWLL
LWLWLLLLLLWLLLLWLLLLWLLLLLLWLLLWWLLLWWLLLLLLWLLWLL
LLLWLLWLWWWLLLWLLLLLWWWLLLWLLLLWWLWWLWLLWWLLLLLLLW
WWWLLLWLWLLLLWLWWLLWLLLLLLLLLLLWWLLWWWLLLWLLWWLWLL
LLLWWLLWWLLLWWWLWLWLWLLWLLLLWLWWLLLLWLWLWLLLLLLWLL
LLLWLWLLWWLLLWLLLLWLLLLLLLWLLLLLLLWLLLLWLLWWWLWLLL
LLWLLLWLWLLLLLLLLWLWWWWLWLLLLLLWLLLWLWLLLLLLWWLWLL
LWWLLLLWWWWLWLWLLWLLLLWLLLWWWWLLWLLLLLLLLLLLWWLLWW