0S000000000000
00000000000000
00011110000000
00000010000000
00000011000000
00000000000000
00000011111000
000000100F0000