LLLLLLLLLLLLLLLLLLLL
LLLLLLLLLLLLLLLLLLLL
LLSLLLLLLLLLLLLLLLLL
LLLLLLLLLLLLLLLLLLLL
WWWWWWWWWLWWWWWWWWWW
LLLLLLLLLLLLLLLLLLLL
WWWWWWWWWWWWWWWWWLWW
LLLLLLLLLLLLLLLLLLLL
WWWWWWWWWWWLWWWWWWWW
LLLLLLLLLLLLLLLLLLLL
WWWWWWWLWWWWWWWWWWWW
LLLLLLLLLLLLLLLLLLLL
WWWWWWWWWWWLWWWWWWWW
LLLLLLLLLLLLLLLLLLLL
LLLLLLLLLLLLLLLLLLLL
LLLLLLLLLLLLLLLELLLL
LLLLLLLLLLLLLLLLLLLL
LLLLLLLLLLLLLLLLLLLL
LLLLLLLLLLLLLLLLLLLL
LLLLLLLLLLLLLLLLLLLL